# # # #########
#...#......#
..#.#.####.#
###.#....#.#
#....###.#.#
####.#F#.#.#
#..#.#.#.#.#
##.#.#.#.#.#
#........#.#
######.###.#
#......#...#
############