 # # # # . # # # # # # #
 # . . . . . . . . . . #
 # . # # # # # # # # . #
 # . # . . . . . . # . #
 # . # . # # # # . # . #
 # . # . . # F # . # . #
 # . # . # . . # . # . #
 # . # # # . # . . # . #
 # . . . . . . . # # . #
 # . # # # # # # # . . #
 # . . . . . . . . . # #
 # # # # # # # # # # # #
